8 8
0 7
3 3
_______7
|_____7|
||___7||
|||_7|||
||*_||||
|*___|||
*_____||
_______|
