12 8
0 7
3 3
___________7
||||_|*|7|7|
||||*7_|||7|
*_**_***_**|
|||||7|7||_7
|7|||7||||*7
***_****_*_7
__________*7

