8 8
6 2
7 2
_______7
*|||_|*|
__|****|
**|____7
*|_7||_|
***|||_|
_|*|_|*|
___|__*|